############################################################
############################################################
############################################################
############################################################
############################################################
############################################################
############################################################
############################################################
############################################################
######......................################################
######......................################################
######......................##########¶###¶#################
######......................#######¶#######¶¶###############
######......................##########¶¶¶¶¶#################
######......................######¶#¶≈≈≈≈≈≈¶¶###############
######......................#######¶≈≈≈≈≈≈≈≈≈¶##############
######......................#######¶≈≈≈≈≈≈≈≈≈≈¶#############
######......................######¶≈≈≈≈≈≈≈≈≈≈≈¶#############
######......................######¶≈≈≈≈≈≈≈≈≈≈≈¶#############
######..........P...........::::::====≈≈≈≈≈≈≈≈¶#############
######......................::::::====≈≈≈≈≈≈≈≈¶#############
######..f...................######¶≈≈≈≈≈≈≈≈≈≈≈¶#¶###########
######......................#######¶≈≈≈≈≈≈≈≈≈¶¶#############
######......................#######¶≈≈≈≈≈≈≈≈≈≈¶¶############
######......................#######¶¶¶≈≈≈≈≈¶¶≈¶#¶###########
######......................#########¶¶≈≈¶¶#¶¶##############
######......................##########¶¶¶##¶#¶#¶############
######......................################################
######..................f...################################
######......................################################
######......................################################
######......................################################
###############.############################################
###############.############################################
###############.############################################
###############.############################################
###############.############################################
###############.############################################
###############.#################.......................####
###############.#################.......................####
###############.#################.......................####
###############.#################.......................####
###############.#################.......................####
###############.........................................####
#################################..........f............####
#################################.......................####
#################################.......................####
#################################.......................####
#################################.....f.................####
#################################.......................####
#################################.......................####
#################################.......................####
#################################.......................####
############################################################
############################################################
############################################################
############################################################
############################################################
############################################################
############################################################